| | | | | | | | | | |
| | | | | | | | | | |
| | | | |*| | | | | |
| | | |*| | | | | | |
| | | |*|*|*| | | | |
| | | | | | | | | | |
| | | | | | | | | | |
| | | | | | | | | | |
| | | | | | | | | | |
| | | | | | | | | | |f

This is a 10x10 map