| | | | | | | | |
|*| | | |*|*|*| |
| |*| | | | | | |
| | | | | | | | |
| |*| | | |*|*| |
| |*| | | |*|*| |
| |*| | |*| | | |
| | | | | | | |*|