| | | | | | | | |
| | | | |*|*|*| |
| | | | | | | | |
| | | | | | | | |
| |*| | | |*|*| |
| |*| | | |*|*| |
| |*| | | | | | |
| | | | | | | | |