| |*| | | | | | | | | | | | | |
| | |*| | | | | | | | | | | | |
|*|*|*| | | | | | | | | | | | |
| | | | | | | | | | | | | | | |
| | | | | | | | | | | | | | | |
| | | |*|*|*|*| | | | | | | | |
| | | |*| |*|*|*| | | | | | | |
| | |*|*| | | | | | | | | | | |
| | |*| |*| | | | | | | | | | |
| |*| |*| | | | |*|*| | | | | |
| |*|*| | | | | | |*| | | | | |
| |*| | | | | | | | | | | | | |
| |*| | | | | | | | | | | | | |
| |*| | | | | | | | | | | | | |
| | | | | | | | | | | | | | | |f

