| |*| | | | | | | | | | | | | | |*| | | | | | | |
| | |*| | | | | | | | | | | | | | |*| | | | | | |
|*|*|*| | | | | | | | | | | | |*|*|*| | | | | | |
| | | | | | | | | | | | | | | | | | |*| | | | | |
| | | | | | | | | | | | | | | | | | | | | | | | |
| | | |*|*|*|*| | | | | | | | | |*| |*|*|*|*| | |
| | | |*| |*|*|*| | | | | | | | |*| |*| |*|*|*| |
| | |*|*| | | | | | | | | | | |*| |*|*| | | | | |
| | |*| |*| | | | | | | | | | |*| |*| |*| | | | |
| |*| |*| | | | |*|*| | | | | | |*| |*| | | | |*|
| |*|*| | | | | | |*| | | | | | | |*| | | | | | |
| |*| | | | | | | | | | | | | | | | | | | | | | |
| |*| | | | | | | | | | | | | | |*| | | | | | | |
| |*| | | | | | | | | | | | | | |*| | | | | | | |
| | | | | | | | | | | | | | | | | | | | | | | | |f